1111111111111
1CC1CCC11CCC1
1CC11CCE111C1
1CCCP0CCCCC01
1111111111111