11111111111111111111111
1CC1CCC11CCC00000000011
1CC11CCE111C00000000011
1CCCPCCCCCC000000000011
11111111111111111111111
11111111111111111111111
11111111111111111111111
11111111111111111111111
11111111111111111111111
11111111111111111111111
11111111111111111111111
11111111111111111111111